-과거설정- (이미 만들어진 직업)

-----1----- (어린 시절)

책벌레 - 어린시절 당신은 도서관에서 책을 읽으며 시간을 보냈습니다. (+기초연금술, 공격,방어 -10)

건강한 아이 - 잘 놀고 잘 자랐습니다. (공격,방어 +10)

조숙한 아이 - 정력 넘치는 아버지를 보며 자랐습니다. (+V둔감무시, +방중술)

교회의 고아 - 부모님은 당신을 교회에 버리고 떠나갔습니다. 교회에서 자라는 동안 신앙심을 가졌습니다.(특정 직업의 호감도 시작 +200)

봉마의  - 당신의 가문은 한 요괴를 대를 이어 몸속에 봉인해 왔습니다. 이번에는 당신 차례군요! 그런데 이 봉인진이 새겨지면 왠지 불행하다는 소문이 있습니다. (행운-3,공격,방어+5,마력+20)

전생 신동 - 당신은 지구라는 곳의 2020년대를 살다가 전생하여 이곳에서 다시 태어났습니다! 그런데 전생에서의 지식을 딱히 활용할게 없네요! 다만 어렸을 때부터 비범한 모습을 보여 신동이라 소문이 났습니다. (소문LV+3)

허약한 아이 - 심장이 멈춘채 태어났다가 의사가 심폐소생술로 간신히 살아났습니다. 그 때문인지 심장이 약하지만 죽었다 살아난 경험이 있어서 인지 주변의 마력이 더 잘 인지 됩니다.(+회복느림, 마력+10)

빈민가의 고아 - 어머니는 3살즈음에 당신을 빈민가에 버리고 혼자 떠났습니다. 개같은 년! 그러나 지금은 다 커서 여관을 운영하게 되었기에 빈민가의 아이들 사이에서 전설이 되었습니다. (공격,방어+5, 소문LV+3)

반인반마의 아이 - 당신은 보통의 다른 아이들과는 모습이 다릅니다. 어머니께서는 당신의 아버지가 마족 인큐버스라고 가르쳐 주셨습니다. 그래서 그 아버지는 어디있냐고요? 어디 또 다른 여자들이나 후리고 있겠죠! (마력+10, +수수께끼의 매력, +뿔)

귀족의 사생아 - 당신의 아버지는 하룻밤의 불장난으로 당신을 잉태시켰습니다. 그 가문에서 당신을 별로 좋게 생각하지 않겠군요. 그래도 어찌저찌 살면서 좋은 것은 먹고 다녔습니다만, 나이를 적당히 먹고 나서 내쫓겼습니다.(공격,방어+5, 돈+10000)

상인의 아이 - 당신의 아버지는 꽤 큰 규모의 상단을 가지고 있었고, 당신은 5번째 아들이였습니다. 회계에 대해 열심히 공부하였습니다. (매출+5%, 돈+5000)


-----2----- (과거 경력)

연금술사의 제자 - 고약한 성격의 연금술사의 밑으로 들어가 몇가지 지식을 배웠습니다 (+기초연금술,+대량제작Ⅰ, 공격,방어 -10)

용병 - 그럭저럭 실력있는 용병이였습니다. (공격,방어 +30)

던전 탐험가 - 던전을 다니며 경험을 쌓았습니다. (채집기능+3, 도축기능+3,공격,방어+10)

정력이 곧 힘 - 대부분의 시간을 정력을 쌓는데만 시간을 보냈습니다. (+절륜, +능숙한손가락, +혀놀림, 기교+3)

보증인 - 마음씨 좋은 당신은 친구의 보증을 서주었다가, 빚더미에 앉게 되었습니다. 호구라고 소문이 자자하군요. (빚 -500000, 소문LV+5)

정보원 - 지금은 은퇴했지만 정보길드의 길드원이였습니다. 밉보이지 않으려면 손님인 정보길드원에게 대폭할인 해줘야 합니다. (소문LV+5, 매출-10%)

깨어진 봉인 - ('나루토' 선행) 천년간 이어져 온 봉인진에 금이 가고 있었고, 보수 방법은 옛적에 소실되었습니다. 그리고 기나긴 봉인이 깨어지고, 잠들어 있던 대요괴 '구미호'가 깨어났습니다....만 너무 오랜 봉인으로 대부분의 힘이 소실 되었습니다.(행운+3, 마력-10, 구금된 대요괴 '구미호')

저주받은 마법사 - 당신은 꽤 실력있는 마법사였습니다. 그런데 던전을 탐험하던 도중 리치와 마주쳐 전투를 벌였고 간신히 승리하였지만, 그에게 저주의 각인을 받아버렸습니다. 그것은 아주 무시무시한 '발기부전의 저주'였습니다!!! 그나마 다행히 교회의 '성수'로 '발기부전의 저주'를 일시적으로 풀 수 있습니다. 그러나 저주는 일시적으로 풀릴 때마다 강해지기에 더 많은 '성수'를 필요로 합니다. 자료를 찾아본 결과 전설적인 정력제 '핫세스69'를 먹으면 '발기부전의 저주'를 벗어날 수 있다고 합니다. (공격,방어-5, 마력+50, +기초연금술, [절륜] 선택불가, '발기'에 '성수'가 필요함.) 

요리사 - 뭘 만들든 보통으로 맛있습니다. (요리LV+10)


-----3----- (현재 상황?)

물려받은 여관 - 여관을 부모님께 물려받았습니다. (돈+5000)

은퇴한 용병 - 무릎에 화살을 맞은 것이 악화되어 은퇴하였지만 실력이 꽤 좋았습니다. 그동안 모았던 돈과 대출로 여관하나를 차렸습니다. (빚-10000000, 공격,방어 +50, 소문LV+10)

인신매매 조직원 - 꽤 큰 인신매매 조직의 조직원입니다. 조직은 당신을 믿고 이 여관을 맡겼습니다. 조직을 위해 매번 일정기간 안에 위험을 감수하고 대상자를 팔거나 돈을 바쳐야합니다. 당신께서 보스가 되면 모든 수입이 당신께 되지 않을까요? 뒷골목은 주먹이 가깝습니다. (10일마다 매출에 비례하여 조직에 돈을 내거나 대상자를 팔아야합니다.)

전설의 도박꾼 - 당신은 도박꾼들 사이에서 전설이라 칭해지는 도박사 입니다. 당신은 도박을 하며 상대방을 농락하며 승리하였고, 몇번은 귀족을 상대로 승리하여 건물도 몇채나 얻어냈습니다. 그러나 너무 욕심을 낸 탓이였을까요? 어느날 밤길에 습격을 받았고, 당신을 살기위해 오늘 얻은 '던전도시 아헤가'의 허름한 여관의 땅문서만 가지고 헐레벌떡 도시를 빠져나올 수 밖에 없었습니다.(공격,방어 -50, 돈+5000)

출소된 강간범 - 본래 30년은 감옥에서 썩어야 했지만, 당신은 어떤 특별한 이유로 출소하게 되었습니다. 그리고 그 특별한 이유를 만들어 준 어떤 사람이 먹고살길이 막막한 당신을 위해 허름한 여관을 살 수 있도록 무이자 대출을 해줬습니다. 그러나 세상에 공짜는 없는법. 무슨일이 일어나게 될까요? 그리고 여성 실종사건이 있을때마다 경비원들은 당신을 의심할 것입니다. (위험도 상승률 2배, 빚-50000000, 기교+5)

준비된 호텔매니저 - 당신은 여관업을 하기 위해 꽤 오랜시간 공부하고 돈을 준비해왔습니다. 다만 돈은 역시 여전히 부족하기에 대출하였습니다. (빛-30000000, 외관LV+20, 객실LV+20, 소문LV+5, 요리LV+10)

사이코패스 - 당신은 연금술의 발전을 위해서 인체실험이 불가피함을 깨달았습니다. 연금술 길드에서는 인체실험은 자원자 이외의 사람에게 하는 것은 절대로 허가 하지 않았죠. 그러나 곧 좋은 아이디어를 생각해냈습니다. 여관을 운영하면서 손님들에게 약을 몰래 먹여 실험결과를 보는 것입니다! 당신은 그 목적을 위해 대출까지 받아가며 여관 하나를 장만 했습니다. (빚 -50000000, +기초연금술, +연금지식Ⅰ,+대량제작Ⅰ)


-------------------------------------------------------------------------------

(누군가가 추가해준 것들)

만들어진 존재 - 당신은 어떠한 이유로 만들어진 존재였습니다...만 '작은'사고가 생겨서 도망 칠 수 밖에 없었습니다. (커스텀가능)

몰락귀족/왕족 - 한 때는 상당한 부를 가진 귀족/왕족 이였지만, 어떠한 이유로 몰락하였습니다. 그래도 귀족/왕족 이라고 나름대로 지식은 많이 가지고 있네요. (생각안남)

사냥꾼 - (배경설정 생각안난다)

요정의 친구 - 당신은 작은 요정(팅커벨같이 인간형 쪼끄미들)들과 친하게 지냈습니다. 당신이 곤란할 때 도움을 주곤 합니다. 그런데 몇몇 사람들은 그런 당신을 시샘하는군요. (마력친화, 가끔 요정이 선물이나 도움을 주거나, 음식을 몰래 먹음)

탈주한 호문쿨루스 - 당신은 유명한 연금술사가 심부름꾼으로 쓰기위해 만들어낸 호문쿨루스입니다. 오랜시간 주인을 보좌해왔지만 겉은 멀쩡해보여도 속은 늙고 병들어버린 당신은 주인에게 굴려지는걸 버틸 수 없어 사직서만 남겨두고 도망쳤으며 어깨너머로 배운 연금지식을 사용해 돈을 모아 '던전도시 아헤가'에 정착하기로 결정했습니다.

사자소생 - 단란한 가정에서 행복한 삶을 살던 당신은 어느날 강도의 습격으로 행복의 끝을 맞이했습니다. 하지만 삶의 허무한 끝을 봤을 터인 당신은 한 제단에서 깨어납니다.
눈 앞에는 검은 후드를 쓴 누군가가 서 있었습니다. 그 사람은 당신을 되살린 사람이라고 밝히며, 당신을 필요로 한다고 말합니다.
• 살아는 있지만, 몸은 여전히 시체입니다. 툭 하면 억 하고 살점이 떨어질 것입니다. (- 최대체력, + 회복느림)
• 당신을 살린 사람은 당신에게 여러가지 기술을 가르쳐줬습니다. (+ 무작위 긍정적 특성 2개)

소매치기(고아선행) - 당신은 어두운 뒷골목의 주민입니다. 어리숙한 관광객은 당신의 훌륭한 타겟이며 때로는 한끼 식사를 위해 위험한일도 마다하지 않습니다.

--------------------------------------------------------------------------------

(이후 생각나는 것들)

엘프의 노예 - 한때는 엘프들에게 잡혀 살았습니다. 엘프들은 매우 혈기왕성합니다. 특히나 밤에는 더욱 혈기왕성해지죠... (절륜, 능숙한 손가락, 회복느림)


